Size=20,14,6
Layer z=0

2 2 2 2 2 2 2 2 2 2 2 2 2 2 2 2 2 2 2 2
2 2 2 2 2 2 2 2 2 2 2 2 2 2 2 2 2 2 2 2
2 2 2 2 2 2 2 2 2 2 2 2 2 2 2 2 2 2 2 2
2 2 2 2 2 2 2 2 2 2 2 2 2 2 2 2 2 2 2 2
2 2 2 2 2 2 2 2 2 2 2 2 2 2 2 2 2 2 2 2
2 2 2 2 2 2 2 2 2 2 2 2 2 2 2 2 2 2 2 2
2 2 2 2 2 2 2 2 2 2 2 2 2 2 2 2 2 2 2 2
2 2 2 2 2 2 2 2 2 2 2 2 2 2 2 2 2 2 2 2
2 2 2 2 2 2 2 2 2 2 2 2 2 2 2 2 2 2 2 2
2 2 2 2 2 2 2 2 2 2 2 2 2 2 2 2 2 2 2 2
2 2 2 2 2 2 2 2 2 2 2 2 2 2 2 2 2 2 2 2
2 2 2 2 2 2 2 2 2 2 2 2 2 2 2 2 2 2 2 2
2 2 2 2 2 2 2 2 2 2 2 2 2 2 2 2 2 2 2 2
2 2 2 2 2 2 2 2 2 2 2 2 2 2 2 2 2 2 2 2

Layer z=1

2 2 2 2 2 2 2 2 2 2 2 2 2 2 2 2 2 2 2 2
2 2 2 2 2 2 2 2 2 2 2 2 2 2 2 2 2 2 2 2
2 0 0 0 0 0 0 0 0 0 0 0 0 0 0 0 0 0 0 2
2 2 0 0 2 2 2 2 2 2 2 2 2 2 2 0 0 2 2 2
2 2 0 0 2 2 2 2 2 2 2 2 2 2 2 0 0 2 2 2
2 2 0 0 2 2 2 2 2 2 2 2 2 2 2 0 0 2 2 2
2 2 0 0 2 2 2 2 2 2 2 2 2 2 2 0 0 2 2 2
2 2 0 0 2 2 2 2 2 2 2 2 2 2 2 0 0 2 2 2
2 2 0 0 2 2 2 2 2 2 2 2 2 2 2 0 0 2 2 2
2 2 0 0 2 2 2 2 2 2 2 2 2 2 2 0 0 2 2 2
2 2 0 0 2 2 2 2 2 2 2 2 2 2 2 0 0 2 2 2
2 2 0 0 2 2 2 2 2 2 2 2 2 2 2 0 0 2 2 2
2 0 0 0 0 0 0 0 0 0 0 0 0 0 0 0 0 0 0 2
2 2 2 2 2 2 2 2 2 2 2 2 2 2 2 2 2 2 2 2



Layer z=2

2 2 2 2 2 2 2 2 2 2 2 2 2 2 2 2 2 2 2 2
2 2 2 2 2 2 2 2 2 2 2 2 2 2 2 2 2 2 2 2
2 0 0 0 0 0 0 0 0 0 0 0 0 0 0 0 0 0 0 2
2 2 0 0 2 2 2 2 2 2 2 2 2 2 2 0 0 2 2 2
2 2 0 0 2 2 2 2 2 2 2 2 2 2 2 0 0 2 2 2
2 2 0 0 2 2 2 2 2 2 2 2 2 2 2 0 0 2 2 2
2 2 0 0 2 2 2 2 2 2 2 2 2 2 2 0 0 2 2 2
2 2 0 0 2 2 2 2 2 2 2 2 2 2 2 0 0 2 2 2
2 2 0 0 2 2 2 2 2 2 2 2 2 2 2 0 0 2 2 2
2 2 0 0 2 2 2 2 2 2 2 2 2 2 2 0 0 2 2 2
2 2 0 0 2 2 2 2 2 2 2 2 2 2 2 0 0 2 2 2
2 0 0 0 0 0 0 0 0 0 0 0 0 0 0 0 0 0 0 2
2 0 0 0 0 0 0 0 0 0 0 0 0 0 0 0 0 0 0 2
2 2 2 2 2 2 2 2 2 2 2 2 2 2 2 2 2 2 2 2

Layer z=3

2 2 2 2 2 2 2 2 2 2 2 2 2 2 2 2 2 2 2 2
2 2 2 2 2 2 2 2 2 2 2 2 2 2 2 2 2 2 2 2
2 0 0 0 0 0 0 0 0 0 0 0 0 0 0 0 0 0 0 2
2 2 0 0 2 2 2 2 2 2 2 2 2 2 2 0 0 2 2 2
2 2 0 0 2 2 2 2 2 2 2 2 2 2 2 0 0 2 2 2
2 2 0 0 2 2 2 2 2 2 2 2 2 2 2 0 0 2 2 2
2 2 0 0 2 2 2 2 2 2 2 2 2 2 2 0 0 2 2 2
2 2 0 0 2 2 2 2 2 2 2 2 2 2 2 0 0 2 2 2
2 2 0 0 2 2 2 2 2 2 2 2 2 2 2 0 0 2 2 2
2 2 0 0 2 2 2 2 2 2 2 2 2 2 2 0 0 2 2 2
2 2 0 0 2 2 2 2 2 2 2 2 2 2 2 0 0 2 2 2
2 2 0 0 2 2 2 2 2 2 2 2 2 2 2 0 0 2 2 2
2 0 0 0 0 0 0 0 0 0 0 0 0 0 0 0 0 0 0 2
2 2 2 2 2 2 2 2 2 2 2 2 2 2 2 2 2 2 2 2

Layer z=4
2 2 2 2 2 2 2 2 2 2 2 2 2 2 2 2 2 2 2 2
2 2 2 2 2 2 2 2 2 2 2 2 2 2 2 2 2 2 2 2
2 0 0 0 0 0 0 0 0 0 0 0 0 0 0 0 0 0 0 2
2 2 0 0 2 2 2 2 2 2 2 2 2 2 2 0 0 2 2 2
2 2 0 0 2 2 2 2 2 2 2 2 2 2 2 0 0 2 2 2
2 2 0 0 2 2 2 2 2 2 2 2 2 2 2 0 0 2 2 2
2 2 0 0 2 2 2 2 2 2 2 2 2 2 2 0 0 2 2 2
2 2 0 0 2 2 2 2 2 2 2 2 2 2 2 0 0 2 2 2
2 2 0 0 2 2 2 2 2 2 2 2 2 2 2 0 0 2 2 2
2 2 0 0 2 2 2 2 2 2 2 2 2 2 2 0 0 2 2 2
2 2 0 0 2 2 2 2 2 2 2 2 2 2 2 0 0 2 2 2
2 2 0 0 2 2 2 2 2 2 2 2 2 2 2 0 0 2 2 2
2 0 0 0 0 0 0 0 0 0 0 0 0 0 0 0 0 0 0 2
2 2 2 2 2 2 2 2 2 2 2 2 2 2 2 2 2 2 2 2


Layer z=5

2 2 2 2 2 2 2 2 2 2 2 2 2 2 2 2 2 2 2 2
2 2 2 2 2 2 2 2 2 2 2 2 2 2 2 2 2 2 2 2
2 2 2 2 2 2 2 2 2 2 2 2 2 2 2 2 2 2 2 2
2 2 2 2 2 2 2 2 2 2 2 2 2 2 2 2 2 2 2 2
2 2 2 2 2 2 2 2 2 2 2 2 2 2 2 2 2 2 2 2
2 2 2 2 2 2 2 2 2 2 2 2 2 2 2 2 2 2 2 2
2 2 2 2 2 2 2 2 2 2 2 2 2 2 2 2 2 2 2 2
2 2 2 2 2 2 2 2 2 2 2 2 2 2 2 2 2 2 2 2
2 2 2 2 2 2 2 2 2 2 2 2 2 2 2 2 2 2 2 2
2 2 2 2 2 2 2 2 2 2 2 2 2 2 2 2 2 2 2 2
2 2 2 2 2 2 2 2 2 2 2 2 2 2 2 2 2 2 2 2
2 2 2 2 2 2 2 2 2 2 2 2 2 2 2 2 2 2 2 2
2 2 2 2 2 2 2 2 2 2 2 2 2 2 2 2 2 2 2 2
2 2 2 2 2 2 2 2 2 2 2 2 2 2 2 2 2 2 2 2