Size=22,22,12
Layer z=0
2 2 2 2 2 2 2 2 2 2 2 2 2 2 2 2 2 2 2 2 2 2
2 2 2 2 2 2 2 2 2 2 2 2 2 2 2 2 2 2 2 2 2 2
2 2 2 2 2 2 2 2 2 2 2 2 2 2 2 2 2 2 2 2 2 2
2 2 2 2 2 2 2 2 2 2 2 2 2 2 2 2 2 2 2 2 2 2
2 2 2 2 2 2 2 2 2 2 2 2 2 2 2 2 2 2 2 2 2 2
2 2 2 2 2 2 2 2 2 2 2 2 2 2 2 2 2 2 2 2 2 2
2 2 2 2 2 2 2 2 2 2 2 2 2 2 2 2 2 2 2 2 2 2
2 2 2 2 2 2 2 2 2 2 2 2 2 2 2 2 2 2 2 2 2 2
2 2 2 2 2 2 2 2 2 2 2 2 2 2 2 2 2 2 2 2 2 2
2 2 2 2 2 2 2 2 2 2 2 2 2 2 2 2 2 2 2 2 2 2
2 2 2 2 2 2 2 2 2 2 2 2 2 2 2 2 2 2 2 2 2 2
2 2 2 2 2 2 2 2 2 2 2 2 2 2 2 2 2 2 2 2 2 2
2 2 2 2 2 2 2 2 2 2 2 2 2 2 2 2 2 2 2 2 2 2
2 2 2 2 2 2 2 2 2 2 2 2 2 2 2 2 2 2 2 2 2 2
2 2 2 2 2 2 2 2 2 2 2 2 2 2 2 2 2 2 2 2 2 2
2 2 2 2 2 2 2 2 2 2 2 2 2 2 2 2 2 2 2 2 2 2
2 2 2 2 2 2 2 2 2 2 2 2 2 2 2 2 2 2 2 2 2 2
2 2 2 2 2 2 2 2 2 2 2 2 2 2 2 2 2 2 2 2 2 2
2 2 2 2 2 2 2 2 2 2 2 2 2 2 2 2 2 2 2 2 2 2
2 2 2 2 2 2 2 2 2 2 2 2 2 2 2 2 2 2 2 2 2 2
2 2 2 2 2 2 2 2 2 2 2 2 2 2 2 2 2 2 2 2 2 2
2 2 2 2 2 2 2 2 2 2 2 2 2 2 2 2 2 2 2 2 2 2

Layer z=1
2 2 2 2 2 2 2 2 2 2 2 2 2 2 2 2 2 2 2 2 2 2
2 0 0 0 0 0 0 0 0 0 0 0 0 0 0 0 2 0 0 0 2 2
2 0 0 0 0 0 0 0 0 0 0 0 0 0 0 0 2 0 0 0 2 2
2 0 0 0 0 0 0 0 0 0 0 0 0 0 0 0 2 0 0 0 2 2
2 2 2 2 2 2 2 2 2 2 2 2 2 0 0 0 2 0 0 0 2 2
2 0 0 0 0 0 0 0 2 0 0 0 2 0 0 0 0 0 0 0 2 2
2 0 0 0 0 0 0 0 2 0 0 0 2 0 0 0 0 0 0 0 2 2
2 0 0 0 0 0 0 0 2 0 0 0 2 0 0 0 0 0 0 0 2 2
2 0 0 0 2 0 0 0 2 0 0 0 2 2 2 2 2 0 0 0 2 2
2 0 0 0 2 0 0 0 0 0 0 0 2 0 0 0 0 0 0 0 2 2
2 0 0 0 2 0 0 0 0 0 0 0 2 0 0 0 0 0 0 0 2 2
2 0 0 0 2 0 0 0 0 0 0 0 2 0 0 0 0 0 0 0 2 2
2 0 0 0 2 2 2 2 2 2 2 2 2 0 0 0 2 2 2 2 2 2
2 0 0 0 0 0 0 0 0 0 0 0 2 0 0 0 2 0 0 0 2 2
2 0 0 0 0 0 0 0 0 0 0 0 2 0 0 0 2 0 0 0 2 2
2 0 0 0 0 0 0 0 0 0 0 0 2 0 0 0 2 0 0 0 2 2
2 0 0 0 2 2 2 2 2 0 0 0 2 0 0 0 2 0 0 0 2 2
2 0 0 0 0 0 0 0 2 0 0 0 0 0 0 0 0 0 0 0 2 2
2 0 0 0 0 0 0 0 2 0 0 0 0 0 0 0 0 0 0 0 2 2
2 0 0 0 0 0 0 0 2 0 0 0 0 0 0 0 0 0 0 0 2 2
2 2 2 2 2 2 2 2 2 2 2 2 2 2 2 2 2 2 2 2 2 2
2 2 2 2 2 2 2 2 2 2 2 2 2 2 2 2 2 2 2 2 2 2

Layer z=2
2 2 2 2 2 2 2 2 2 2 2 2 2 2 2 2 2 2 2 2 2 2
2 0 0 0 0 0 0 0 0 0 0 0 0 0 0 0 2 0 0 0 2 2
2 0 0 0 0 0 0 0 0 0 0 0 0 0 0 0 2 0 0 0 2 2
2 0 0 0 0 0 0 0 0 0 0 0 0 0 0 0 2 0 0 0 2 2
2 2 2 2 2 2 2 2 2 2 2 2 2 0 0 0 2 0 0 0 2 2
2 0 0 0 0 0 0 0 2 0 0 0 2 0 0 0 0 0 0 0 2 2
2 0 0 0 0 0 0 0 2 0 0 0 2 0 0 0 0 0 0 0 2 2
2 0 0 0 0 0 0 0 2 0 0 0 2 0 0 0 0 0 0 0 2 2
2 0 0 0 2 0 0 0 2 0 0 0 2 2 2 2 2 0 0 0 2 2
2 0 0 0 2 0 0 0 0 0 0 0 2 0 0 0 0 0 0 0 2 2
2 0 0 0 2 0 0 0 0 0 0 0 2 0 0 0 0 0 0 0 2 2
2 0 0 0 2 0 0 0 0 0 0 0 2 0 0 0 0 0 0 0 2 2
2 0 0 0 2 2 2 2 2 2 2 2 2 0 0 0 2 2 2 2 2 2
2 0 0 0 0 0 0 0 0 0 0 0 2 0 0 0 2 0 0 0 2 2
2 0 0 0 0 0 0 0 0 0 0 0 2 0 0 0 2 0 0 0 2 2
2 0 0 0 0 0 0 0 0 0 0 0 2 0 0 0 2 0 0 0 2 2
2 0 0 0 2 2 2 2 2 0 0 0 2 0 0 0 2 0 0 0 2 2
2 0 0 0 0 0 0 0 2 0 0 0 0 0 0 0 0 0 0 0 2 2
2 0 0 0 0 0 0 0 2 0 0 0 0 0 0 0 0 0 0 0 2 2
2 0 0 0 0 0 0 0 2 0 0 0 0 0 0 0 0 0 0 0 2 2
2 2 2 2 2 2 2 2 2 2 2 2 2 2 2 2 2 2 2 2 2 2
2 2 2 2 2 2 2 2 2 2 2 2 2 2 2 2 2 2 2 2 2 2

Layer z=3
2 2 2 2 2 2 2 2 2 2 2 2 2 2 2 2 2 2 2 2 2 2
2 0 0 0 0 0 0 0 0 0 0 0 0 0 0 0 2 0 0 0 2 2
2 0 0 0 0 0 0 0 0 0 0 0 0 0 0 0 2 0 0 0 2 2
2 0 0 0 0 0 0 0 0 0 0 0 0 0 0 0 2 0 0 0 2 2
2 2 2 2 2 2 2 2 2 2 2 2 2 0 0 0 2 0 0 0 2 2
2 0 0 0 0 0 0 0 2 0 0 0 2 0 0 0 0 0 0 0 2 2
2 0 0 0 0 0 0 0 2 0 0 0 2 0 0 0 0 0 0 0 2 2
2 0 0 0 0 0 0 0 2 0 0 0 2 0 0 0 0 0 0 0 2 2
2 0 0 0 2 0 0 0 2 0 0 0 2 2 2 2 2 0 0 0 2 2
2 0 0 0 2 0 0 0 0 0 0 0 2 0 0 0 0 0 0 0 2 2
2 0 0 0 2 0 0 0 0 0 0 0 2 0 0 0 0 0 0 0 2 2
2 0 0 0 2 0 0 0 0 0 0 0 2 0 0 0 0 0 0 0 2 2
2 0 0 0 2 2 2 2 2 2 2 2 2 0 0 0 2 2 2 2 2 2
2 0 0 0 0 0 0 0 0 0 0 0 2 0 0 0 2 0 0 0 2 2
2 0 0 0 0 0 0 0 0 0 0 0 2 0 0 0 2 0 0 0 2 2
2 0 0 0 0 0 0 0 0 0 0 0 2 0 0 0 2 0 0 0 2 2
2 0 0 0 2 2 2 2 2 0 0 0 2 0 0 0 2 0 0 0 2 2
2 0 0 0 0 0 0 0 2 0 0 0 0 0 0 0 0 0 0 0 2 2
2 0 0 0 0 0 0 0 2 0 0 0 0 0 0 0 0 0 0 0 2 2
2 0 0 0 0 0 0 0 2 0 0 0 0 0 0 0 0 0 0 0 2 2
2 2 2 2 2 2 2 2 2 2 2 2 2 2 2 2 2 2 2 2 2 2
2 2 2 2 2 2 2 2 2 2 2 2 2 2 2 2 2 2 2 2 2 2

Layer z=4
2 2 2 2 2 2 2 2 2 2 2 2 2 2 2 2 2 2 2 2 2 2
2 0 0 0 0 0 0 0 0 0 0 0 0 0 0 0 2 0 0 0 2 2
2 0 0 0 0 0 0 0 0 0 0 0 0 0 0 0 2 0 0 0 2 2
2 0 0 0 0 0 0 0 0 0 0 0 0 0 0 0 2 0 0 0 2 2
2 2 2 2 2 2 2 2 2 2 2 2 2 0 0 0 2 0 0 0 2 2
2 0 0 0 0 0 0 0 2 0 0 0 2 0 0 0 0 0 0 0 2 2
2 0 0 0 0 0 0 0 2 0 0 0 2 0 0 0 0 0 0 0 2 2
2 0 0 0 0 0 0 0 2 0 0 0 2 0 0 0 0 0 0 0 2 2
2 0 0 0 2 0 0 0 2 0 0 0 2 2 2 2 2 0 0 0 2 2
2 0 0 0 2 0 0 0 0 0 0 0 2 0 0 0 0 0 0 0 2 2
2 0 0 0 2 0 0 0 0 0 0 0 2 0 0 0 0 0 0 0 2 2
2 0 0 0 2 0 0 0 0 0 0 0 2 0 0 0 0 0 0 0 2 2
2 0 0 0 2 2 2 2 2 2 2 2 2 0 0 0 2 2 2 2 2 2
2 0 0 0 0 0 0 0 0 0 0 0 2 0 0 0 2 0 0 0 2 2
2 0 0 0 0 0 0 0 0 0 0 0 2 0 0 0 2 0 0 0 2 2
2 0 0 0 0 0 0 0 0 0 0 0 2 0 0 0 2 0 0 0 2 2
2 0 0 0 2 2 2 2 2 0 0 0 2 0 0 0 2 0 0 0 2 2
2 0 0 0 0 0 0 0 2 0 0 0 0 0 0 0 0 0 0 0 2 2
2 0 0 0 0 0 0 0 2 0 0 0 0 0 0 0 0 0 0 0 2 2
2 0 0 0 0 0 0 0 2 0 0 0 0 0 0 0 0 0 0 0 2 2
2 2 2 2 2 2 2 2 2 2 2 2 2 2 2 2 2 2 2 2 2 2
2 2 2 2 2 2 2 2 2 2 2 2 2 2 2 2 2 2 2 2 2 2

Layer z=5
2 2 2 2 2 2 2 2 2 2 2 2 2 2 2 2 2 2 2 2 2 2
2 0 0 0 0 0 0 0 0 0 0 0 0 0 0 0 2 0 0 0 2 2
2 0 0 0 0 0 0 0 0 0 0 0 0 0 0 0 2 0 0 0 2 2
2 0 0 0 0 0 0 0 0 0 0 0 0 0 0 0 2 0 0 0 2 2
2 2 2 2 2 2 2 2 2 2 2 2 2 0 0 0 2 0 0 0 2 2
2 0 0 0 0 0 0 0 2 0 0 0 2 0 0 0 0 0 0 0 2 2
2 0 0 0 0 0 0 0 2 0 0 0 2 0 0 0 0 0 0 0 2 2
2 0 0 0 0 0 0 0 2 0 0 0 2 0 0 0 0 0 0 0 2 2
2 0 0 0 2 0 0 0 2 0 0 0 2 2 2 2 2 0 0 0 2 2
2 0 0 0 2 0 0 0 0 0 0 0 2 0 0 0 0 0 0 0 2 2
2 0 0 0 2 0 0 0 0 0 0 0 2 0 0 0 0 0 0 0 2 2
2 0 0 0 2 0 0 0 0 0 0 0 2 0 0 0 0 0 0 0 2 2
2 0 0 0 2 2 2 2 2 2 2 2 2 0 0 0 2 2 2 2 2 2
2 0 0 0 0 0 0 0 0 0 0 0 2 0 0 0 2 0 0 0 2 2
2 0 0 0 0 0 0 0 0 0 0 0 2 0 0 0 2 0 0 0 2 2
2 0 0 0 0 0 0 0 0 0 0 0 2 0 0 0 2 0 0 0 2 2
2 0 0 0 2 2 2 2 2 0 0 0 2 0 0 0 2 0 0 0 2 2
2 0 0 0 0 0 0 0 2 0 0 0 0 0 0 0 0 0 0 0 2 2
2 0 0 0 0 0 0 0 2 0 0 0 0 0 0 0 0 0 0 0 2 2
2 0 0 0 0 0 0 0 2 0 0 0 0 0 0 0 0 0 0 0 2 2
2 2 2 2 2 2 2 2 2 2 2 2 2 2 2 2 2 2 2 2 2 2
2 2 2 2 2 2 2 2 2 2 2 2 2 2 2 2 2 2 2 2 2 2

Layer z=6
2 2 2 2 2 2 2 2 2 2 2 2 2 2 2 2 2 2 2 2 2 2
2 0 0 0 0 0 0 0 0 0 0 0 0 0 0 0 2 0 0 0 2 2
2 0 0 0 0 0 0 0 0 0 0 0 0 0 0 0 2 0 0 0 2 2
2 0 0 0 0 0 0 0 0 0 0 0 0 0 0 0 2 0 0 0 2 2
2 2 2 2 2 2 2 2 2 2 2 2 2 0 0 0 2 0 0 0 2 2
2 0 0 0 0 0 0 0 2 0 0 0 2 0 0 0 0 0 0 0 2 2
2 0 0 0 0 0 0 0 2 0 0 0 2 0 0 0 0 0 0 0 2 2
2 0 0 0 0 0 0 0 2 0 0 0 2 0 0 0 0 0 0 0 2 2
2 0 0 0 2 0 0 0 2 0 0 0 2 2 2 2 2 0 0 0 2 2
2 0 0 0 2 0 0 0 0 0 0 0 2 0 0 0 0 0 0 0 2 2
2 0 0 0 2 0 0 0 0 0 0 0 2 0 0 0 0 0 0 0 2 2
2 0 0 0 2 0 0 0 0 0 0 0 2 0 0 0 0 0 0 0 2 2
2 0 0 0 2 2 2 2 2 2 2 2 2 0 0 0 2 2 2 2 2 2
2 0 0 0 0 0 0 0 0 0 0 0 2 0 0 0 2 0 0 0 2 2
2 0 0 0 0 0 0 0 0 0 0 0 2 0 0 0 2 0 0 0 2 2
2 0 0 0 0 0 0 0 0 0 0 0 2 0 0 0 2 0 0 0 2 2
2 0 0 0 2 2 2 2 2 0 0 0 2 0 0 0 2 0 0 0 2 2
2 0 0 0 0 0 0 0 2 0 0 0 0 0 0 0 0 0 0 0 2 2
2 0 0 0 0 0 0 0 2 0 0 0 0 0 0 0 0 0 0 0 2 2
2 0 0 0 0 0 0 0 2 0 0 0 0 0 0 0 0 0 0 0 2 2
2 2 2 2 2 2 2 2 2 2 2 2 2 2 2 2 2 2 2 2 2 2
2 2 2 2 2 2 2 2 2 2 2 2 2 2 2 2 2 2 2 2 2 2

Layer z=7
2 2 2 2 2 2 2 2 2 2 2 2 2 2 2 2 2 2 2 2 2 2
2 0 0 0 0 0 0 0 0 0 0 0 0 0 0 0 2 0 0 0 2 2
2 0 0 0 0 0 0 0 0 0 0 0 0 0 0 0 2 0 0 0 2 2
2 0 0 0 0 0 0 0 0 0 0 0 0 0 0 0 2 0 0 0 2 2
2 2 2 2 2 2 2 2 2 2 2 2 2 0 0 0 2 0 0 0 2 2
2 0 0 0 0 0 0 0 2 0 0 0 2 0 0 0 0 0 0 0 2 2
2 0 0 0 0 0 0 0 2 0 0 0 2 0 0 0 0 0 0 0 2 2
2 0 0 0 0 0 0 0 2 0 0 0 2 0 0 0 0 0 0 0 2 2
2 0 0 0 2 0 0 0 2 0 0 0 2 2 2 2 2 0 0 0 2 2
2 0 0 0 2 0 0 0 0 0 0 0 2 0 0 0 0 0 0 0 2 2
2 0 0 0 2 0 0 0 0 0 0 0 2 0 0 0 0 0 0 0 2 2
2 0 0 0 2 0 0 0 0 0 0 0 2 0 0 0 0 0 0 0 2 2
2 0 0 0 2 2 2 2 2 2 2 2 2 0 0 0 2 2 2 2 2 2
2 0 0 0 0 0 0 0 0 0 0 0 2 0 0 0 2 0 0 0 2 2
2 0 0 0 0 0 0 0 0 0 0 0 2 0 0 0 2 0 0 0 2 2
2 0 0 0 0 0 0 0 0 0 0 0 2 0 0 0 2 0 0 0 2 2
2 0 0 0 2 2 2 2 2 0 0 0 2 0 0 0 2 0 0 0 2 2
2 0 0 0 0 0 0 0 2 0 0 0 0 0 0 0 0 0 0 0 2 2
2 0 0 0 0 0 0 0 2 0 0 0 0 0 0 0 0 0 0 0 2 2
2 0 0 0 0 0 0 0 2 0 0 0 0 0 0 0 0 0 0 0 2 2
2 2 2 2 2 2 2 2 2 2 2 2 2 2 2 2 2 2 2 2 2 2
2 2 2 2 2 2 2 2 2 2 2 2 2 2 2 2 2 2 2 2 2 2

Layer z=8
2 2 2 2 2 2 2 2 2 2 2 2 2 2 2 2 2 2 2 2 2 2
2 0 0 0 0 0 0 0 0 0 0 0 0 0 0 0 2 0 0 0 2 2
2 0 0 0 0 0 0 0 0 0 0 0 0 0 0 0 2 0 0 0 2 2
2 0 0 0 0 0 0 0 0 0 0 0 0 0 0 0 2 0 0 0 2 2
2 2 2 2 2 2 2 2 2 2 2 2 2 0 0 0 2 0 0 0 2 2
2 0 0 0 0 0 0 0 2 0 0 0 2 0 0 0 0 0 0 0 2 2
2 0 0 0 0 0 0 0 2 0 0 0 2 0 0 0 0 0 0 0 2 2
2 0 0 0 0 0 0 0 2 0 0 0 2 0 0 0 0 0 0 0 2 2
2 0 0 0 2 0 0 0 2 0 0 0 2 2 2 2 2 0 0 0 2 2
2 0 0 0 2 0 0 0 0 0 0 0 2 0 0 0 0 0 0 0 2 2
2 0 0 0 2 0 0 0 0 0 0 0 2 0 0 0 0 0 0 0 2 2
2 0 0 0 2 0 0 0 0 0 0 0 2 0 0 0 0 0 0 0 2 2
2 0 0 0 2 2 2 2 2 2 2 2 2 0 0 0 2 2 2 2 2 2
2 0 0 0 0 0 0 0 0 0 0 0 2 0 0 0 2 0 0 0 2 2
2 0 0 0 0 0 0 0 0 0 0 0 2 0 0 0 2 0 0 0 2 2
2 0 0 0 0 0 0 0 0 0 0 0 2 0 0 0 2 0 0 0 2 2
2 0 0 0 2 2 2 2 2 0 0 0 2 0 0 0 2 0 0 0 2 2
2 0 0 0 0 0 0 0 2 0 0 0 0 0 0 0 0 0 0 0 2 2
2 0 0 0 0 0 0 0 2 0 0 0 0 0 0 0 0 0 0 0 2 2
2 0 0 0 0 0 0 0 2 0 0 0 0 0 0 0 0 0 0 0 2 2
2 2 2 2 2 2 2 2 2 2 2 2 2 2 2 2 2 2 2 2 2 2
2 2 2 2 2 2 2 2 2 2 2 2 2 2 2 2 2 2 2 2 2 2

Layer z=9
2 2 2 2 2 2 2 2 2 2 2 2 2 2 2 2 2 2 2 2 2 2
2 0 0 0 0 0 0 0 0 0 0 0 0 0 0 0 2 0 0 0 2 2
2 0 0 0 0 0 0 0 0 0 0 0 0 0 0 0 2 0 0 0 2 2
2 0 0 0 0 0 0 0 0 0 0 0 0 0 0 0 2 0 0 0 2 2
2 2 2 2 2 2 2 2 2 2 2 2 2 0 0 0 2 0 0 0 2 2
2 0 0 0 0 0 0 0 2 0 0 0 2 0 0 0 0 0 0 0 2 2
2 0 0 0 0 0 0 0 2 0 0 0 2 0 0 0 0 0 0 0 2 2
2 0 0 0 0 0 0 0 2 0 0 0 2 0 0 0 0 0 0 0 2 2
2 0 0 0 2 0 0 0 2 0 0 0 2 2 2 2 2 0 0 0 2 2
2 0 0 0 2 0 0 0 0 0 0 0 2 0 0 0 0 0 0 0 2 2
2 0 0 0 2 0 0 0 0 0 0 0 2 0 0 0 0 0 0 0 2 2
2 0 0 0 2 0 0 0 0 0 0 0 2 0 0 0 0 0 0 0 2 2
2 0 0 0 2 2 2 2 2 2 2 2 2 0 0 0 2 2 2 2 2 2
2 0 0 0 0 0 0 0 0 0 0 0 2 0 0 0 2 0 0 0 2 2
2 0 0 0 0 0 0 0 0 0 0 0 2 0 0 0 2 0 0 0 2 2
2 0 0 0 0 0 0 0 0 0 0 0 2 0 0 0 2 0 0 0 2 2
2 0 0 0 2 2 2 2 2 0 0 0 2 0 0 0 2 0 0 0 2 2
2 0 0 0 0 0 0 0 2 0 0 0 0 0 0 0 0 0 0 0 2 2
2 0 0 0 0 0 0 0 2 0 0 0 0 0 0 0 0 0 0 0 2 2
2 0 0 0 0 0 0 0 2 0 0 0 0 0 0 0 0 0 0 0 2 2
2 2 2 2 2 2 2 2 2 2 2 2 2 2 2 2 2 2 2 2 2 2
2 2 2 2 2 2 2 2 2 2 2 2 2 2 2 2 2 2 2 2 2 2

Layer z=10
2 2 2 2 2 2 2 2 2 2 2 2 2 2 2 2 2 2 2 2 2 2
2 0 0 0 0 0 0 0 0 0 0 0 0 0 0 0 2 0 0 0 2 2
2 0 0 0 0 0 0 0 0 0 0 0 0 0 0 0 2 0 0 0 2 2
2 0 0 0 0 0 0 0 0 0 0 0 0 0 0 0 2 0 0 0 2 2
2 2 2 2 2 2 2 2 2 2 2 2 2 0 0 0 2 0 0 0 2 2
2 0 0 0 0 0 0 0 2 0 0 0 2 0 0 0 0 0 0 0 2 2
2 0 0 0 0 0 0 0 2 0 0 0 2 0 0 0 0 0 0 0 2 2
2 0 0 0 0 0 0 0 2 0 0 0 2 0 0 0 0 0 0 0 2 2
2 0 0 0 2 0 0 0 2 0 0 0 2 2 2 2 2 0 0 0 2 2
2 0 0 0 2 0 0 0 0 0 0 0 2 0 0 0 0 0 0 0 2 2
2 0 0 0 2 0 0 0 0 0 0 0 2 0 0 0 0 0 0 0 2 2
2 0 0 0 2 0 0 0 0 0 0 0 2 0 0 0 0 0 0 0 2 2
2 0 0 0 2 2 2 2 2 2 2 2 2 0 0 0 2 2 2 2 2 2
2 0 0 0 0 0 0 0 0 0 0 0 2 0 0 0 2 0 0 0 2 2
2 0 0 0 0 0 0 0 0 0 0 0 2 0 0 0 2 0 0 0 2 2
2 0 0 0 0 0 0 0 0 0 0 0 2 0 0 0 2 0 0 0 2 2
2 0 0 0 2 2 2 2 2 0 0 0 2 0 0 0 2 0 0 0 2 2
2 0 0 0 0 0 0 0 2 0 0 0 0 0 0 0 0 0 0 0 2 2
2 0 0 0 0 0 0 0 2 0 0 0 0 0 0 0 0 0 0 0 2 2
2 0 0 0 0 0 0 0 2 0 0 0 0 0 0 0 0 0 0 0 2 2
2 2 2 2 2 2 2 2 2 2 2 2 2 2 2 2 2 2 2 2 2 2
2 2 2 2 2 2 2 2 2 2 2 2 2 2 2 2 2 2 2 2 2 2

Layer z=11
2 2 2 2 2 2 2 2 2 2 2 2 2 2 2 2 2 2 2 2 2 2
2 2 2 2 2 2 2 2 2 2 2 2 2 2 2 2 2 2 2 2 2 2
2 2 2 2 2 2 2 2 2 2 2 2 2 2 2 2 2 2 2 2 2 2
2 2 2 2 2 2 2 2 2 2 2 2 2 2 2 2 2 2 2 2 2 2
2 2 2 2 2 2 2 2 2 2 2 2 2 2 2 2 2 2 2 2 2 2
2 2 2 2 2 2 2 2 2 2 2 2 2 2 2 2 2 2 2 2 2 2
2 2 2 2 2 2 2 2 2 2 2 2 2 2 2 2 2 2 2 2 2 2
2 2 2 2 2 2 2 2 2 2 2 2 2 2 2 2 2 2 2 2 2 2
2 2 2 2 2 2 2 2 2 2 2 2 2 2 2 2 2 2 2 2 2 2
2 2 2 2 2 2 2 2 2 2 2 2 2 2 2 2 2 2 2 2 2 2
2 2 2 2 2 2 2 2 2 2 2 2 2 2 2 2 2 2 2 2 2 2
2 2 2 2 2 2 2 2 2 2 2 2 2 2 2 2 2 2 2 2 2 2
2 2 2 2 2 2 2 2 2 2 2 2 2 2 2 2 2 2 2 2 2 2
2 2 2 2 2 2 2 2 2 2 2 2 2 2 2 2 2 2 2 2 2 2
2 2 2 2 2 2 2 2 2 2 2 2 2 2 2 2 2 2 2 2 2 2
2 2 2 2 2 2 2 2 2 2 2 2 2 2 2 2 2 2 2 2 2 2
2 2 2 2 2 2 2 2 2 2 2 2 2 2 2 2 2 2 2 2 2 2
2 2 2 2 2 2 2 2 2 2 2 2 2 2 2 2 2 2 2 2 2 2
2 2 2 2 2 2 2 2 2 2 2 2 2 2 2 2 2 2 2 2 2 2
2 2 2 2 2 2 2 2 2 2 2 2 2 2 2 2 2 2 2 2 2 2
2 2 2 2 2 2 2 2 2 2 2 2 2 2 2 2 2 2 2 2 2 2
2 2 2 2 2 2 2 2 2 2 2 2 2 2 2 2 2 2 2 2 2 2

