Layer=1

2 2 2 2 2 0 0 0 0 0 0 0
2 2 2 2 2 0 0 0 0 0 0 0
2 2 2 2 2 0 0 0 0 0 0 0
2 2 2 2 2 0 0 0 0 0 0 0
2 2 2 2 2 0 0 0 0 0 0 0
2 2 2 2 2 0 0 0 0 0 0 0
2 2 2 2 2 0 0 0 0 0 0 0
2 2 2 2 2 0 0 0 0 0 0 0
2 2 2 2 2 2 2 2 2 2 2 2
2 2 2 2 2 2 2 2 2 2 2 2 
2 2 2 2 2 2 2 2 2 2 2 2
2 2 2 2 2 2 2 2 2 2 2 2



Layer=2

2 2 2 2 2 0 0 0 0 0 0 0
2 2 2 2 2 0 0 0 0 0 0 0
2 2 2 2 2 0 0 0 0 0 0 0
2 2 2 2 2 0 0 0 0 0 0 0
2 2 2 2 2 0 0 0 0 0 0 0
2 2 2 2 2 0 0 0 0 0 0 0
2 2 2 2 2 0 0 0 0 0 0 0
2 2 2 2 2 0 0 0 0 0 0 0
2 2 2 2 2 2 2 2 2 2 2 2
2 2 2 2 2 2 2 2 2 2 2 2 
2 2 2 2 2 2 2 2 2 2 2 2
2 2 2 2 2 2 2 2 2 2 2 2


Layer=3

2 2 2 2 2 0 0 0 0 0 0 0
2 2 2 2 2 0 0 0 0 0 0 0
2 2 2 2 2 0 0 0 0 0 0 0
2 2 2 2 2 0 0 0 0 0 0 0
2 2 2 2 2 0 0 0 0 0 0 0
2 2 2 2 2 0 0 0 0 0 0 0
2 2 2 2 2 0 0 0 0 0 0 0
2 2 2 2 2 0 0 0 0 0 0 0
2 2 2 2 2 2 2 2 2 2 2 2
2 2 2 2 2 2 2 2 2 2 2 2 
2 2 2 2 2 2 2 2 2 2 2 2
2 2 2 2 2 2 2 2 2 2 2 2


Layer=4

2 2 2 2 2 0 0 0 0 0 0 0
2 2 2 2 2 0 0 0 0 0 0 0
2 2 2 2 2 0 0 0 0 0 0 0
2 2 2 2 2 0 0 0 0 0 0 0
2 2 2 2 2 0 0 0 0 0 0 0
2 2 2 2 2 0 0 0 0 0 0 0
2 2 2 2 2 0 0 0 0 0 0 0
2 2 2 2 2 0 0 0 0 0 0 0
2 2 2 2 2 2 2 2 2 2 2 2
2 2 2 2 2 2 2 2 2 2 2 2 
2 2 2 2 2 2 2 2 2 2 2 2
2 2 2 2 2 2 2 2 2 2 2 2


Layer=5

2 2 2 2 2 0 0 0 0 0 0 0
2 2 2 2 2 0 0 0 0 0 0 0
2 2 2 2 2 0 0 0 0 0 0 0
2 2 2 2 2 0 0 0 0 0 0 0
2 2 2 2 2 0 0 0 0 0 0 0
2 2 2 2 2 0 0 0 0 0 0 0
2 2 2 2 2 0 0 0 0 0 0 0
2 2 2 2 2 0 0 0 0 0 0 0
2 2 2 2 2 2 2 2 2 2 2 2
2 2 2 2 2 2 2 2 2 2 2 2 
2 2 2 2 2 2 2 2 2 2 2 2
2 2 2 2 2 2 2 2 2 2 2 2

